1111111111111111111111111111111
1000001000000000100000100000101
1011101111101011101110101010101
1000101000101010001000101010001
1010101010101010111011111011101
1010100010101010100010000010101
1010111110111010101110101110101
1010100010100010100010101000002
1010101110101010111010101110111
1010101000101010001010100010001
1010101011101111101011101011101
1010101010000010001000101010001
1010101011111010111110111010111
1010101010001010001010100010001
1110101010101011101010101111101
1000100000100010001010100010001
1011111110111110111010111011111
1000001000100000100010001000001
1011101111101111111011101011101
1010100000100000031010001000101
1010111110111111111010111110101
1010000010100000100000100010101
1010101110101011101111101010101
1010100010101010001000001000101
1011111010101010111110111111101
1000100010101000100010000010101
1110101110101111101011111010101
1000100010001000001010001000101
1011111011111110111010101111101
1000000000000000100000100000001
1111111111111111111111111111111


