11111111111111111111111111111111111
10100000001000000000100000001000001
10101110111011101111101110101111101
10101010000000100000000010100000101
10101011111111111111101110111110101
10100010001000000000101000100010101
10111011101011111110111011101010101
10001000101000100000100010001000101
10101110101110111011101111101111101
10100010000010001000001000101000101
10111011111011101111111010101010101
10101000001010100000000010100010001
10101110101010111111111110111111101
10100010101010000000000010100000101
10101010111010111011111010101110111
10101010000010001010000010100010001
10101111111110111010111110111011101
10100000100010100010000010100010001
10111010101010101111111110101110111
10001010101000101000100010001000101
11101010101111101010101011111011101
10001010000010001010001000100010001
10111011111110111011111110101111101
10100000100010000000001000100003101
10111111101011111111111010111111101
10000000101000000000100010100000001
11111110101111111110101110101111101
10000010100010000010001000101000001
10111110111010111011111011101011111
10100010001000001010001000001000101
10101011101111101010111111111110101
10101000100000101010100010001000101
10101110111110111010101010101011101
10000010000000000010001000100000001
11111111111111111111111111121111111


