11111111111111111111111
10000000000010000000101
11111111101110101110101
10001000001000100010001
10101011111011101011101
10100010001013101010101
10111110101010111010101
10000010100010100010001
10111010111110101111111
10101000100010100000001
10101111101010101111101
10000000001010101000101
11111111101110101011101
10000000101000100010001
10111111101011111110111
10001000001000100010001
10101011111110101010101
10100010001000101010101
10111110101011101011101
10100000101000001010001
10111111101111111010101
10000000000000001000101
11111111111111211111111


